111111
100101
101001
110P01
111111