11111111111111111111111111111111111
10000000000000000000000000000000001
10000000000000000000000000000000001
10000000000000000000000000000000001
10000000000000000000000000000000001
10000011111111111111111111111100001
10000000000000000000000000000010001
10000000000000000000000000000001001
10000011111111111111111110000000001
10000000000000000000000010000001001
10000000000000000000000100000010001
10000000000000000000001000000100001
10000000000000000000010000001000001
10000000000000000000100000010000001
10000000000000000000100000100000001
10000000000000000001000001000000001
10000000000000000001000001000000001
10000000000000000001000001000000001
11111111111111111111111111111111111