111111111
110000011
110111011
110000011
111111111