EA w1.xpm
NO w2.xpm   
WE w3.xpm
SO w4.xpm



F   164, 169, 2
C 153 ,   204, 255




111111111111111111111
10100000100000000000111111
101010101011111110001
1000101000100000100011111
111110101111101011101000011
100000101000101000001111111
101111101011101111111
101000001010100000101
101011111010111110101
101010001010100010101
101110101010101010101
100000101010001010001
111111101011111011101
100000101000100010001
101110101110101110111
101000100000100010101
111011111111111010101
1M0010000000000010001
110000011011111111101
1N0000000000000000001
111111111111111111111
    



