EA w1.xpm
NO w2.xpm   
WE w3.xpm
SO w4.xpm



F   164, 169, 2
C 153 ,   204, 255




1111111111
1000000001
10000011001
1000001001
10N000D001
1011000001
1111111111
1111111111



